    ######          
    ##   #          
    ##$  #          
  ####   ##         
  ##  $   #         
####      #   ######
##        #####  ..#
## $  $           .#
############@##   .#    
#################### 