#########
#  @#####
# $$#####
# $ ###.#
### ###.#
###    .#
##   #  #
##   ####
#########
