#########
##@ #####
## $  ###
### # ###
#.# #  ##
#.$  # ##
#.   $ ##
#########
