#########
###.#####
### #####
###$ $.##
#. $@####
####$####
####.####
#########
