#########
###..####
### .####
##  $.###
## $  ###
#  #$$ ##
#  @   ##
#########
